W W W W W W W W W W W W W W W W W W W
W E m m m m m m m m G m m m m m R G W
W m m G m m G m R R G R R m m R m m W
W m R R m R R m G G R G G m m m R m W
W m G m m G m m R R G m m m m m m m W
W m m m m m m m m m G R R m m m m m W
W m m m m m m m m m m m m m m m m m W
W m m m R m m m R m m m m m m R m P W
W m m m G m m m m m R R m m m G m m W
W m m m m m m m m m m m m m m m m m W
W W W W W W W W W W W W W W W W W W W