W W W W W W W W W W W W W W W W W W
W m m m m m P m R m m m G m m m m W
W m m m m m m m m m m m m m m m m W
W m m m m m m m m m m m m m R m m W
W R G G R m R R R m R G R m G m E W
W R G G R m R G G m R G R m G m m W
W R R R R m R R R m R R R m G m m W
W R G G R m R G G m m R m m m m m W
W R G G R m R R R G G R m m R m m W
W m m m m m m m m m m m m m m m m W
W m m m m m m m m m m m m m m m m W
W W W W W W W W W W W W W W W W W W