W W W W W W W W W W W W W W W W W W
W m m m m m P m R m m m G m m m m W
W m m m m m m m m m m m m m m m m W
W m m m m m m m m m m m m m R m m W
W G R R G m G G G m R G R m G m E W
W G R R G m G R R m R G R m G m m W
W G G G G m G G G m R R R m G m m W
W G R R G m G R R m m R m m m m m W
W G R R G m G G G m m R m m R m m W
W m m m m m m m m m m m m m m m m W
W m m m m m m m m m m m m m m m m W
W W W W W W W W W W W W W W W W W W