W W W W W W W W W W W W W W W W W W 
W m m m R m m m m m m m m m m m m W
W m m m m m m R m m m m m R m m m W
W P m m G m m G m m m m m m m m m W
W m m m m m m m m m m m m m m m m W
W m m m m m m m m m R R m m m m E W
W m m m m R m m m m G R m m m m m W
W m R m m G m m R m m m m m m m m W
W m m m m m m m m m m m m G m m m W
W m m m m m m m m m m m m m m m m W
W W W W W W W W W W W W W W W W W W 