W W W W W W W W W W W W W W W W W W 
W m m m m m m m m m m m m R m m m W
W m m m m m m G G m m m m G m m m W
W m m R m m m R R m m m m m m m R W
W m m G m m m m m m m m m m m m G W
W m m m m m m m m G m m m m m m G W
W m m m m R m m m m m m R G m m m W
W m m m m G m m m m m m m m m m m W
W E m m m m m m R m m m m m m m m W
W m m m m m m P R G m m m m m m m W
W W W W W W W W W W W W W W W W W W