W W W W W W W W W W W W W W W W W W
W P m m R m m m m m R m m m m R m W
W m m m G m m m m m G m m m m G m W
W m m m m m m m m m m m m m m m m W
W m R m m m m m m m m m m m m m m W
W m R G m m m G R R R R m m m G m W
W m R R m m m G G G G G m m m R R W
W m G G m m m m G G G G R m m m G W
W m m m m m m m m m m m m m m m m W
W m G G m m m m R m R m R m m m m W
W m G G m m m m m m m m m m m m E W
W W W W W W W W W W W W W W W W W W